1111111111111111111111111111111111111
10CCCCCCCCCCCCCCCCCCCCCCCCCCCCCCCCCC1
1C1C1C1C1C1C1C1C1C1C1C1C1C1C1C1C1C1C1
1CCCCCCCCCCCCCCCCCCCCCCCCCCCCCCCCCCC1
11C1C1C1C1C1C1C1C1C1C1C1C1C1C1C1C1C11
1CCCCCCCCCCCCCCCCCCCCCCCCCCCCCCCCCCC1
1C1C1C1C1C1C1C1C1C1C1C1C1C1C1C1C1C1C1
1CCCCCCCCCCCCCCCCCCCCCCCCCCCCCCCCCCC1
11C1C1C1C1C1C1C1C1C1C1C1C1C1C1C1C1C11
1CCCCCCCCCCCCCCCCCCCCCCCCCCCCCCCCCCC1
1C1C1C1C1C1C1C1C1C1C1C1C1C1C1C1C1C1C1
1CCCCCCCCCCCCCCCCCCCCCCCCCCCCCCCCCCC1
11C1C1C1C1C1C1C1C1C1C1C1C1C1C1C1C1C11
1CCCCCCCCCCCCCCCCCCCCCCCCCCCCCCCCCCC1
1C1C1C1C1C1C1C1C1C1C1C1C1C1C1C1C1C1C1
1CCCCCCCCCCCCCCCCCCCCCCCCCCCCCCCCCCC1
11C1C1C1C1C1C1C1C1C1C1C1C1C1C1C1C1C11
1CCCCCCCCCCCCCCCCCCCCCCCCCCCCCCCCCCC1
1C1C1C1C1C1C1C1C1C1C1C1C1C1C1C1C1C1C1
1CCCCCCCCCCCCCCCCCCCCCCCCCCCCCCCCCEP1
1111111111111111111111111111111111111
