11111111111111111111111
100P000000000000C000001
1E111111111111111111101
101111111111111111111C1
10111111111111111111101
10111111111111111111101
101111111110111111111C1
1C111111110001111111101
10111111111011111111101
10111111111111111111101
101111111111111111111C1
1C111111111111111111101
10111111111111111111101
101111111111111111111C1
1000000C000000C00000001
11111111111111111111111