11111111111111
10E00001111111
11110111111111
11110001111111
11111101111111
100C00C00C00C1
1000C00C00C001
10C00C00C00C01
100C00C00C00C1
1000C00C00C001
10C00C00C00CP1
11111111111111