1111111111111
10E0C00C0C011
1111111111011
100C000C00011
1011111111111
1000C00C0P111
1111111111111