1111111111111
1000000C00011
1111111111011
100C000C00011
1011111111111
1000C00C0PE11
1111111111111