111111111111111
100010001111001
101111011111101
101110011110001
100110000000111
1000000P0010001
1111111E1C11101
1111110101111C1
111111111111111
